8
8

10

WWWWWWWW
W......W
<......W
W......W
W^.....W
W......W
W......W
WWWWWWWW
