10
10

10

WWWWWWWWWW
W........W
W........W
W........W
W........W
W.....^..W
W........W
W........W
W........W
WWvWWWWWWW
